float	floated
give	gave
wish	wished
cost	cost
assign	assigned
swap	swapped
teach	taught
hand	handed
make	made
bring	brought
pay	paid
mail	mailed
read	read
write	wrote
serve	served
cause	caused
sell	sold
take	took
charge	charged
allow	allowed
loan	loaned
promise	promised
tell	told
afford	afforded
deny	denied
lend	lent
owe	owed
send	sent
award	awarded
leave	left
bet	bet
quote	quoted
show	showed
offer	offered
feed	fed
do	did
allot	allotted
flip	flipped